Name	title	coding
t3_qqi45f	Students who live alone. How you manage it out and what is your budget	
t3_qple7p	Did not meet the requirements on conditional offer	
t3_qlcvar	btm 200 online	
t3_qmx5wu	What's going on at Space Concordia	
t3_qm1eee	Teamwork with 10 teammates	
t3_ql2ywv	Does the FG building connect to the John Molson building?	
t3_qptic5	What kind of phone do you use? (Survey for a class)	
t3_qouo3n	COMM 205	
t3_qplp47	Conconrdia Engr courses attendance policy	
t3_qm2jtm	Absolute professor dilemma-&gt; Anthony Noce or Anca Alecsandru	
t3_qoxt8d	What would people say is the easiest math course to take a Concordia?	
t3_qp5j44	Concordia or uwindsor	
t3_qm5my8	looking for paid tutorials	
t3_qpl6dx	Work-study program	
t3_qmry9i	Relevent post, this scammer is around Concordia (St. Catherines just west of rue Guy)	
t3_qq5d1b	COMP 335 Syllabus	
t3_qngpnq	MATH 204, MATH 205 delivery question	
t3_qo26js	Permanent code international student.	
t3_qlyd20	CAQ and Study Permit	
t3_qn079w	Soccer Tournament	
t3_qp6olo	Anyone here doing options trading	
t3_qmnj38	Freshman Questions	
t3_qpvjxz	DISC Inquiry	
t3_qqpo5q	Don’t go to Concordia for arts	
t3_qmopar	Survey for our Statistics Class! :)	
t3_qmz7j7	Can anyone share the Econ 301 course outline with me?	
t3_qo535h	Im in Software Engineering and I have two options next semester. Either to take the ENGR 233 with Chantal David but take the SOEN 228 with Donald Peter Davies. OR take ENGR 233 with Alexei Kokotov but take SOEN 228 with Hakim Mella . Which option should I go for?	
t3_qmoiy3	Do I have hope to pass my class?	
t3_qn0dnv	Self-study source for MATH and PHYS	
t3_qp2lc5	SOS tutoring for Math 209	
t3_qndfs9	Is there a limit to how many DISC you can have?	
t3_qnf3mt	To do checklist on student centre after I applied (I'm international so it asks for like visa expense documents, etc), do I need to do it before or after I have a decision?	
t3_qqb0oc	Comp 218	
t3_qmm8cj	Math 204 Advice ?	
t3_qprn6y	Final year worries	
t3_qlkt9z	STL (Laval Buses) Strike: November 3rd, 15th, 26th	
t3_qpr2og	Guys , what’s the best website/app to find apartments for rent for students?	
t3_qpuhjr	Have four courses, planning to disc one tonight. Would I become a part time student?	
t3_qlgutl	Can we Petition Removal Of A Prof From A Teaching Position?	
t3_qpxh7l	PHYS 206 - Route of least resistance?	
t3_qlvcl8	How is Nicolas Lepage-Saucier as a teacher?	
t3_qnb3i5	Is a tutor allowed to give a quiz after stating no quiz would be given?	
t3_qly38g	COURSE QUESTION	
t3_qq6isg	PHYS204	
t3_qmavtc	Unable to DISC co-requisite course	
t3_qqm6kf	AFE Financial Aid Question	
t3_qoamk1	Comm 210 help	
t3_qnccmc	Study Permit rant	
t3_qphn14	Chance of concentration mechanical Beng to Soen	
t3_qpp2m2	Retaking a course	
